term,cur,prev,diff,ma7,z_like,total
idea,92,105,-13,32.833,8.791,197
디자인,86,96,-10,30.333,8.554,182
이도,29,0,29,4.833,7.556,29
2025,76,86,-10,29.167,7.317,175
전참시,23,0,23,3.833,6.48,23
21일,27,8,19,5.833,6.198,35
강의,20,0,20,3.333,5.898,20
각막,18,0,18,3.0,5.49,18
코웨이,36,39,-3,12.5,5.181,75
본상,30,27,3,9.5,5.022,57
운세,14,0,14,2.333,4.616,14
프로,30,31,-1,10.5,4.599,63
아이콘,28,31,-3,9.833,4.393,59
정수기,28,31,-3,9.833,4.393,59
실명,13,0,13,2.167,4.382,13
중단,13,0,13,2.167,4.382,13
손상,12,0,12,2.0,4.142,12
경동나비엔,28,35,-7,10.5,4.127,63
디스플레이,32,41,-9,13.333,4.013,80
명곡,12,1,11,2.167,3.978,13
불후의,12,1,11,2.167,3.978,13
신승훈,12,1,11,2.167,3.978,13
카메라,21,18,3,6.833,3.92,41
27세,11,0,11,1.833,3.894,11
모솔,11,0,11,1.833,3.894,11
삼성전자,31,41,-10,13.167,3.853,79
위기,12,0,12,2.333,3.825,14
일상,11,1,10,2.167,3.573,13
고백,11,2,9,2.167,3.573,13
관련주,24,21,3,9.667,3.488,58
oled,28,35,-7,12.5,3.417,75
모솔연애,9,0,9,1.5,3.371,9
삼성,29,30,-1,13.5,3.316,81
lg전자,22,29,-7,9.167,3.186,55
결혼,10,3,7,2.167,3.169,13
16세,8,0,8,1.333,3.094,8
별자리,8,0,8,1.333,3.094,8
살림남,8,0,8,1.333,3.094,8
쇼호스트에,8,0,8,1.333,3.094,8
연하,8,0,8,1.333,3.094,8
오늘의,8,0,8,1.333,3.094,8
인천공항,8,0,8,1.333,3.094,8
지상렬,8,0,8,1.333,3.094,8
활동,12,7,5,3.333,3.067,20
47개,21,32,-11,8.833,3.063,53
hpsp,12,10,2,3.667,2.859,22
부고,12,10,2,3.667,2.859,22
홍보부장,12,10,2,3.667,2.859,22
9월,19,26,-7,8.167,2.808,49
지리,7,0,7,1.167,2.804,7
변우석,8,2,6,1.667,2.764,10
덩실덩실,12,10,2,3.833,2.761,23
에이팩트,12,11,1,3.833,2.761,23
boe,14,16,-2,5.167,2.699,31
16년,14,17,-3,5.167,2.699,31
예방,7,1,6,1.333,2.63,8
연속,14,17,-3,5.333,2.619,32
09월,6,0,6,1.0,2.5,6
lg이노텍,6,0,6,1.0,2.5,6
강사,6,0,6,1.0,2.5,6
김우진씨,6,0,6,1.0,2.5,6
모듈,6,0,6,1.0,2.5,6
바꿔줘,6,0,6,1.0,2.5,6
받았다,6,0,6,1.0,2.5,6
방광살리기,6,0,6,1.0,2.5,6
보냈,6,0,6,1.0,2.5,6
부친상,6,0,6,1.0,2.5,6
비트버니,6,0,6,1.0,2.5,6
사연,6,0,6,1.0,2.5,6
선택,6,0,6,1.0,2.5,6
성공적,6,0,6,1.0,2.5,6
수면장애,6,0,6,1.0,2.5,6
쏠퀴즈,6,0,6,1.0,2.5,6
야간뇨로,6,0,6,1.0,2.5,6
어필,6,0,6,1.0,2.5,6
원인,6,0,6,1.0,2.5,6
이후,6,0,6,1.0,2.5,6
인한,6,0,6,1.0,2.5,6
재미있었어,6,0,6,1.0,2.5,6
전립선,6,0,6,1.0,2.5,6
정답,6,0,6,1.0,2.5,6
정답은,6,0,6,1.0,2.5,6
제작진에,6,0,6,1.0,2.5,6
중요,6,0,6,1.0,2.5,6
진태현,6,0,6,1.0,2.5,6
질환,6,0,6,1.0,2.5,6
출연,6,0,6,1.0,2.5,6
치료가,6,0,6,1.0,2.5,6
퀴즈,6,0,6,1.0,2.5,6
해시태,6,0,6,1.0,2.5,6
허각,6,0,6,1.0,2.5,6
스마트폰,8,4,4,2.0,2.485,12
롯데카드,13,18,-5,5.167,2.393,31
개최,14,11,3,5.833,2.391,35
삼성d,14,20,-6,5.833,2.391,35
2개,14,21,-7,5.833,2.391,35
금상,14,21,-7,5.833,2.391,35
ktx,6,1,5,1.167,2.324,7
경륜경정,6,1,5,1.167,2.324,7
광명역,6,1,5,1.167,2.324,7
대회서,6,1,5,1.167,2.324,7
마라톤,6,1,5,1.167,2.324,7
불법도박,6,1,5,1.167,2.324,7
수술,6,1,5,1.167,2.324,7
아내,6,1,5,1.167,2.324,7
평화,6,1,5,1.167,2.324,7
무쌍,12,16,-4,4.667,2.32,28
포함,14,21,-7,6.0,2.319,36
공모전,14,22,-8,6.0,2.319,36
3대,9,8,1,2.833,2.298,17
주간,13,17,-4,5.5,2.242,33
원가,9,9,0,3.0,2.196,18
캠페인,7,4,3,1.833,2.195,11
아이폰17,15,19,-4,7.0,2.194,42
강남구,5,0,5,0.833,2.178,5
고현정,5,0,5,0.833,2.178,5
고혈압,5,0,5,0.833,2.178,5
공개로,5,0,5,0.833,2.178,5
국악한마당,5,0,5,0.833,2.178,5
극비,5,0,5,0.833,2.178,5
김종국,5,0,5,0.833,2.178,5
도심,5,0,5,0.833,2.178,5
배경으로,5,0,5,0.833,2.178,5
보여서,5,0,5,0.833,2.178,5
산업용,5,0,5,0.833,2.178,5
손상으로,5,0,5,0.833,2.178,5
송가인,5,0,5,0.833,2.178,5
시무,5,0,5,0.833,2.178,5
실명위기,5,0,5,0.833,2.178,5
심쿵,5,0,5,0.833,2.178,5
에스피시스템스,5,0,5,0.833,2.178,5
여유로운,5,0,5,0.833,2.178,5
여전,5,0,5,0.833,2.178,5
온디바이스,5,0,5,0.833,2.178,5
울면서,5,0,5,0.833,2.178,5
웃음,5,0,5,0.833,2.178,5
인순이,5,0,5,0.833,2.178,5
최현욱,5,0,5,0.833,2.178,5
축하파티,5,0,5,0.833,2.178,5
카리스마,5,0,5,0.833,2.178,5
협동로봇,5,0,5,0.833,2.178,5
호소,5,0,5,0.833,2.178,5
세계,10,8,2,3.667,2.173,22
4년,6,0,6,1.333,2.166,8
40도,6,2,4,1.333,2.166,8
건강하십니까,6,2,4,1.333,2.166,8
꺾인다,6,2,4,1.333,2.166,8
잡는,6,2,4,1.333,2.166,8
평균,6,2,4,1.333,2.166,8
1위,9,8,1,3.167,2.099,19
필요,8,8,0,2.667,2.026,16
23조원,6,3,3,1.5,2.023,9
sk하이닉스,6,3,3,1.5,2.023,9
간첩,6,3,3,1.5,2.023,9
계약학과,6,3,3,1.5,2.023,9
곳곳에,6,3,3,1.5,2.023,9
깔린,6,3,3,1.5,2.023,9
나라,6,3,3,1.5,2.023,9
달해,6,3,3,1.5,2.023,9
입시,6,3,3,1.5,2.023,9
줄어,6,3,3,1.5,2.023,9
취업,6,3,3,1.5,2.023,9
피해액만,6,3,3,1.5,2.023,9
학과는,6,3,3,1.5,2.023,9
드라마,5,0,5,1.0,2.0,6
로보스타,5,0,5,1.0,2.0,6
병원,5,0,5,1.0,2.0,6
제주반도체,5,0,5,1.0,2.0,6
속도,8,8,0,2.833,1.926,17
이재용,14,18,-4,7.0,1.92,42
지원,14,26,-12,7.0,1.92,42
2025년,6,4,2,1.667,1.891,10
공주시,6,4,2,1.667,1.891,10
교통안전,6,4,2,1.667,1.891,10
증가,6,4,2,1.667,1.891,10
청소년,6,4,2,1.667,1.891,10
24일,7,7,0,2.333,1.846,14
ai로,7,7,0,2.333,1.846,14
ppt,7,7,0,2.333,1.846,14
15만원,5,2,3,1.167,1.843,7
36만원,5,2,3,1.167,1.843,7
너무,5,2,3,1.167,1.843,7
무슨,5,2,3,1.167,1.843,7
비싸다했더니,5,2,3,1.167,1.843,7
특단,5,2,3,1.167,1.843,7
파격,5,2,3,1.167,1.843,7
한강,5,2,3,1.167,1.843,7
4위,4,0,4,0.667,1.835,4
나가,4,0,4,0.667,1.835,4
넷플릭스,4,0,4,0.667,1.835,4
동안,4,0,4,0.667,1.835,4
밖에,4,0,4,0.667,1.835,4
비결,4,0,4,0.667,1.835,4
소년의,4,0,4,0.667,1.835,4
시간,4,0,4,0.667,1.835,4
임윤아x이채민,4,0,4,0.667,1.835,4
자외선,4,0,4,0.667,1.835,4
차단,4,0,4,0.667,1.835,4
피부,4,0,4,0.667,1.835,4
제품,8,10,-2,3.0,1.83,18
후지필름,8,10,-2,3.0,1.83,18
레이밴,6,5,1,1.833,1.77,11
메타의,6,5,1,1.833,1.77,11
야심작,6,5,1,1.833,1.77,11
100개,7,8,-1,2.5,1.743,15
10시,7,8,-1,2.5,1.743,15
16s,7,8,-1,2.5,1.743,15
3가지,7,8,-1,2.5,1.743,15
3년간,7,8,-1,2.5,1.743,15
5년은,7,8,-1,2.5,1.743,15
61,7,8,-1,2.5,1.743,15
an16s,7,8,-1,2.5,1.743,15
g마켓,7,8,-1,2.5,1.743,15
lcd,7,8,-1,2.5,1.743,15
oled가,7,8,-1,2.5,1.743,15
r96t,7,8,-1,2.5,1.743,15
s22,7,8,-1,2.5,1.743,15
니트로,7,8,-1,2.5,1.743,15
담는다,7,8,-1,2.5,1.743,15
라이,7,8,-1,2.5,1.743,15
바꿔야,7,8,-1,2.5,1.743,15
소통창,7,8,-1,2.5,1.743,15
속도전,7,8,-1,2.5,1.743,15
승부수,7,8,-1,2.5,1.743,15
신박한,7,8,-1,2.5,1.743,15
아이티블루,7,8,-1,2.5,1.743,15
어워드서,7,8,-1,2.5,1.743,15
열쇠,7,8,-1,2.5,1.743,15
열쇠고리,7,8,-1,2.5,1.743,15
울트라로,7,8,-1,2.5,1.743,15
울트라를,7,8,-1,2.5,1.743,15
은상,7,8,-1,2.5,1.743,15
잡은,7,8,-1,2.5,1.743,15
저전력,7,8,-1,2.5,1.743,15
챙기고,7,8,-1,2.5,1.743,15
천옌순,7,8,-1,2.5,1.743,15
추격에,7,8,-1,2.5,1.743,15
추억도,7,8,-1,2.5,1.743,15
코닥의,7,8,-1,2.5,1.743,15
통할까,7,8,-1,2.5,1.743,15
휩쓸어,7,8,-1,2.5,1.743,15
s25,8,9,-1,3.167,1.739,19
lg,13,18,-5,6.833,1.706,41
로봇,5,1,4,1.333,1.702,8
조치,5,2,3,1.333,1.702,8
12,6,6,0,2.0,1.657,12
lake,6,6,0,2.0,1.657,12
swan,6,6,0,2.0,1.657,12
경찰이,6,6,0,2.0,1.657,12
고3,6,6,0,2.0,1.657,12
글래스,6,6,0,2.0,1.657,12
까지,6,6,0,2.0,1.657,12
레스케이프,6,6,0,2.0,1.657,12
말리와,6,6,0,2.0,1.657,12
바다사자,6,6,0,2.0,1.657,12
바다표범,6,6,0,2.0,1.657,12
발레로,6,6,0,2.0,1.657,12
버추얼,6,6,0,2.0,1.657,12
복귀,6,6,0,2.0,1.657,12
분당,6,6,0,2.0,1.657,12
상륙,6,6,0,2.0,1.657,12
생물다양성,6,6,0,2.0,1.657,12
성남시,6,6,0,2.0,1.657,12
세트,6,6,0,2.0,1.657,12
애프터눈,6,6,0,2.0,1.657,12
율동공원서,6,6,0,2.0,1.657,12
조사했던,6,6,0,2.0,1.657,12
지문,6,6,0,2.0,1.657,12
채취해,6,6,0,2.0,1.657,12
탄핵박제,6,6,0,2.0,1.657,12
탐사,6,6,0,2.0,1.657,12
퍼퓸,6,6,0,2.0,1.657,12
포스트잇,6,6,0,2.0,1.657,12
학생을,6,6,0,2.0,1.657,12
협업한,6,6,0,2.0,1.657,12
초점,8,11,-3,3.333,1.651,20
에이서,7,8,-1,2.667,1.646,16
진출,7,8,-1,2.667,1.646,16
4개,7,9,-2,2.667,1.646,16
pc마켓,7,9,-2,2.667,1.646,16
강력,7,9,-2,2.667,1.646,16
개통,7,9,-2,2.667,1.646,16
게이밍,7,9,-2,2.667,1.646,16
대업,7,9,-2,2.667,1.646,16
대중화,7,9,-2,2.667,1.646,16
마우스,7,9,-2,2.667,1.646,16
사고,7,9,-2,2.667,1.646,16
산업계,7,9,-2,2.667,1.646,16
서머리,7,9,-2,2.667,1.646,16
소니,7,9,-2,2.667,1.646,16
옆커폰,7,9,-2,2.667,1.646,16
정보유출,7,9,-2,2.667,1.646,16
정조준,7,9,-2,2.667,1.646,16
초경량,7,9,-2,2.667,1.646,16
프로그램,7,9,-2,2.667,1.646,16
프로맥스,7,9,-2,2.667,1.646,16
공연,5,4,1,1.5,1.573,9
대전,7,9,-2,2.833,1.553,17
커세어,7,9,-2,2.833,1.553,17
프리미엄,7,9,-2,2.833,1.553,17
